1111111111111111111111111
1E00010000000C000C0000001
11100101000100111000CCCC1
10100100100110001000C00C1
100C01000001C000111111111
100C00000011C000111000111
100C000000010000110000001
100C01000001CCCC01000CCC1
100C01000001C0000000C0001
1P10010000010000010000001
1110010010010000010000001
1000010100010000010111101
1110010100010000010111001
1000101000100000101110001
1010101000100000101110011
1111111111111111111111111
