1111111111111111111111111
1E00010000000C000C0000001
11100101000100111000CCCC1
10100100100110001000C00C1
100C01000001C000111111011
100C00000011C000111000011
1P0C000000010000110000001
10100100100110001000C00C1
100C01000001C000111111111
100C00000011C000111000111
100C000000010000110000001
1111111111111111111111111
