11111111111111111111111111
1E00010000000C000C00000011
11100101000100111000CCCC11
10100100100110001000C00C11
100C01000001C0001111110111
100C00000011C0001110000111
1P0C0000000100001100000011
10100100100110001000C00C11
100C01000101C0001111011111
100C00110011C0001110001111
100C00000011C0001110001111
100C00110011C0001110001111
100C01110011C0001110001111
100C00000011C0001110001111
10100100100110001000C00C11
100C01000001C0001111110111
100C00000011C0001110000111
100C0000000100001100000011
10100100100110001000C00C11
100C01000001C0001111110111
100C00000011C0001110000111
100C0000000100001100000011
11111111111111111111111111
