11111111111111111111111111
1E00010000000C000C0000P011
11111111111111111111111111
