11111111111
1P000000001
111001C0001
1C0001100E1
11111111111