1111111
1EP0BC1
11B0101
1100B01
110B101
1100B01
11B0101
1100B01
110B101
1100B01
11B0001
1111111