1111111111111111111111
1E0001000B000C000C0001
111B0101000100111000C1
1010010010B110001000C1
100C01000001C000111111
100C00000011C000111111
100C0000B0010000110001
100C01000001CCCC010001
100C01000001C0000000C1
1P0001000001000B010001
1111111111111111111111