111111111111111
1E00C1000B000C1
111B01010001001
1010010010B1101
100C01000001C01
100000P000110C0
111111111111111
