11111
1E0C1
11011
1P001
11111
